              NO 									./pics/mountain.xpm
    EA     ./pics/mount1.xpm
  SO                  ./pics/mount3.xpm
   WE 			./pics/mount4.xpm
   R 860 420

        F                               ./pics/stone_floor.xpm      




												


                                  





        
         
        C         ./pics/stars.xpm                 
               S 																./pics/sauron.xpm               

1111111111
1000000001
1000000201
10E0000201
1000000201
1111111111