              NO 									./pics/mountain.xpm
    EA     ./pics/mount1.xpm
  SO                  ./pics/mount3.xpm
   WE 			./pics/mount4.xpm
   R 1280 720

        F                               ./pics/stone_floor.xpm      




												


                                  





        
         
        C         ./pics/stars.xpm                 
               S 																./pics/sauron.xpm               

11111111111111111111111111111111111
10000000000000000000000000000000001
10000002000000000000000000000000001
10E00002222222222222222222222222201
10000002000000000000000000000000001
10000000000000000000000000000000001
11111111111111111111111111111111111