             S ./pics/sauron.xpm
			 
			   NO ./pics/mount1.xpm
    EA      ./pics/mountain.xpm
  SO ./pics/mount3.xpm
   WE ./pics/mount4.xpm 
   R 666 333
					
        F 22,   125,     22     






	
        C 61,   93,  182     



        1111111111111111111111111
        1000000000110000000000001
        1011000001110000020000001
        100100000000000N000000001
111111111011000001110000000000001
100000000011000001110111110111111    1111111111
111101111111110111000000100001       1000000001
111101111111110111010100100001       1000000111
110000001101010111000000100001       1000001111
100000000000000011000000100001       10000001111    11111
100000000000000011010100000001       10000000111    10001
110000011101010111110111100001111111110000110111    11111
11110111 1110101 10111101000010000000000011101
11111111 1111111 11111111111110000111111111101
                            110000011      101
                            1110000011     101
                              11000011     101
                               110000111111101
                                10000000000001                                                                                                            
                                11111111111111


        1                                                                     
       111
      11011
     1100011                                                                                             
    110000011
    111101111                                                                  
       111