              NO ./pics/mount1.xpm
    EA ./pics/mountain.xpm
  SO ./pics/mount3.xpm
   WE ./pics/mount4.xpm
   R 800 400

        F   22,125,22  
        C 61,93,182                   
               S ./pics/sauron.xpm               

11111111111111111111111
10000000000000000000001111111111111111111111
100000000N00000111111111111100000000000001
111011111111111111111111111111111111111101
  101    111111111111      101         101111111
  101    10000000000111    101         101
  101    101111111100011111101111111   101111111111
  101    101      1000000000000000011  100000000001
  101    101      1111111111111111001  101111111101
  1011111101                     100111101      101
  1000000001                     100000011      101
  1111111111                     110000011      101
                                 110000011      101
                                 1110000011     101
                                   11000011     101
                                    1100001111111011
                                     110000000000001
                                      11111111111111