              NO ./pics/mountain.xpm	
    EA                                 ./pics/mount1.xpm
  SO  									./pics/mount3.xpm   
   WE ./pics/mount4.xpm
   R 1280 720

        F 255,170,85     













        
         
        C 						85,170,255                   
               S 						./pics/sauron.xpm	

1111111111
1000000001
1000000201
10N0000201
1000000201
1111111111