               NO ./pics/blackbrick.xpm
    EA ./pics/mossy.xpm
  SO ./pics/greystone.xpm
   WE ./pics/neg_eagle.xpm
   R 1280 720

        F 22,   125,     22     













        
         
        C 61,   93,  182                   
               S ./pics/barrel.xpm               

1111111111
1000000001
1000000201
10E0000201
1000000201
1111111111