               NO ./pics/blackbrick.xpm
    EA ./pics/blackstone.xpm
  SO ./pics/greystone.xpm
   WE ./pics/neg_eagle.xpm
   R 1280 720

        F 22,   125,     22     













        
         
        C 61,   93,  182                   
               S ./pics/barrel.xpm               

1111111111
1000000001
10E0002001
1000000001
1111111111