R 1280 720
NO ./pics/eagle.xpm
SO ./pics/greystone.xpm
WE ./pics/redbrick.xpm
EA ./pics/wood.xpm

S ./pics/barrel.xpm
F 17,156,45
C 116,184,252
111111
100001
10E201
100001
111111